"filename", "language", "Java", "XML", "comment", "blank", "total"
"c:\Users\arthu\Documents\GitHub\CS112\MyWork\Project01\BlackjackAI\demo\pom.xml", "XML", 0, 111, 4, 9, 124
"c:\Users\arthu\Documents\GitHub\CS112\MyWork\Project01\BlackjackAI\demo\src\main\java\com\example\Serving.java", "Java", 87, 0, 210, 38, 335
"c:\Users\arthu\Documents\GitHub\CS112\MyWork\Project01\BlackjackAI\demo\src\main\java\com\example\Training.java", "Java", 140, 0, 182, 51, 373
"c:\Users\arthu\Documents\GitHub\CS112\MyWork\Project01\BlackjackAI\demo\src\test\java\com\example\AppTest.java", "Java", 6, 0, 11, 4, 21
"c:\Users\arthu\Documents\GitHub\CS112\MyWork\Project01\BlackjackAI\demo\target\classes\com\example\Serving.class", "Java", 49, 0, 0, 0, 49
"c:\Users\arthu\Documents\GitHub\CS112\MyWork\Project01\BlackjackAI\demo\target\classes\com\example\Training.class", "Java", 92, 0, 0, 0, 92
"c:\Users\arthu\Documents\GitHub\CS112\MyWork\Project01\BlackjackAI\demo\target\test-classes\com\example\AppTest.class", "Java", 6, 0, 0, 0, 6
"c:\Users\arthu\Documents\GitHub\CS112\MyWork\Project01\BlackjackDealer\Dealer.class", "Java", 83, 0, 0, 0, 83
"c:\Users\arthu\Documents\GitHub\CS112\MyWork\Project01\BlackjackDealer\Dealer.java", "Java", 110, 0, 19, 4, 133
"c:\Users\arthu\Documents\GitHub\CS112\MyWork\Project01\BlackjackDealer\DealerCard.class", "Java", 38, 0, 0, 0, 38
"c:\Users\arthu\Documents\GitHub\CS112\MyWork\Project01\BlackjackDealer\DealerCard.java", "Java", 52, 0, 5, 4, 61
"c:\Users\arthu\Documents\GitHub\CS112\MyWork\Project01\BlackjackDealer\DealerDeck.class", "Java", 41, 0, 12, 0, 53
"c:\Users\arthu\Documents\GitHub\CS112\MyWork\Project01\BlackjackDealer\DealerDeck.java", "Java", 123, 0, 18, 8, 149
"c:\Users\arthu\Documents\GitHub\CS112\MyWork\Project01\BlackjackDealer\DealerInfo.class", "Java", 8, 0, 0, 0, 8
"c:\Users\arthu\Documents\GitHub\CS112\MyWork\Project01\BlackjackDealer\DealerInfo.java", "Java", 5, 0, 0, 0, 5
"c:\Users\arthu\Documents\GitHub\CS112\MyWork\Project01\BlackjackDealer\DealerPlayers.class", "Java", 87, 0, 0, 0, 87
"c:\Users\arthu\Documents\GitHub\CS112\MyWork\Project01\BlackjackDealer\DealerPlayers.java", "Java", 201, 0, 100, 11, 312
"c:\Users\arthu\Documents\GitHub\CS112\MyWork\Project01\BlackjackPlayer\Blackjack.class", "Java", 10, 0, 0, 0, 10
"c:\Users\arthu\Documents\GitHub\CS112\MyWork\Project01\BlackjackPlayer\Blackjack.java", "Java", 11, 0, 0, 0, 11
"c:\Users\arthu\Documents\GitHub\CS112\MyWork\Project01\BlackjackPlayer\GameLogic.class", "Java", 36, 0, 0, 0, 36
"c:\Users\arthu\Documents\GitHub\CS112\MyWork\Project01\BlackjackPlayer\GameLogic.java", "Java", 153, 0, 203, 13, 369
"c:\Users\arthu\Documents\GitHub\CS112\MyWork\Project01\BlackjackPlayer\ParseInputs.class", "Java", 68, 0, 9, 1, 78
"c:\Users\arthu\Documents\GitHub\CS112\MyWork\Project01\BlackjackPlayer\ParseInputs.java", "Java", 226, 0, 44, 14, 284
"c:\Users\arthu\Documents\GitHub\CS112\MyWork\Project01\BlackjackPlayer\Player.class", "Java", 32, 0, 0, 0, 32
"c:\Users\arthu\Documents\GitHub\CS112\MyWork\Project01\BlackjackPlayer\Player.java", "Java", 58, 0, 7, 4, 69
"c:\Users\arthu\Documents\GitHub\CS112\MyWork\Project01\BlackjackPlayer\PlayerCard.class", "Java", 39, 0, 0, 0, 39
"c:\Users\arthu\Documents\GitHub\CS112\MyWork\Project01\BlackjackPlayer\PlayerCard.java", "Java", 52, 0, 5, 4, 61
"c:\Users\arthu\Documents\GitHub\CS112\MyWork\Project01\BlackjackPlayer\PlayerDeck.class", "Java", 21, 0, 5, 0, 26
"c:\Users\arthu\Documents\GitHub\CS112\MyWork\Project01\BlackjackPlayer\PlayerDeck.java", "Java", 53, 0, 7, 3, 63
"c:\Users\arthu\Documents\GitHub\CS112\MyWork\Project01\OldFiles\Serving.java", "Java", 71, 0, 143, 36, 250
"c:\Users\arthu\Documents\GitHub\CS112\MyWork\Project01\OldFiles\Training.java", "Java", 129, 0, 182, 51, 362
"Total", "-", 2087, 111, 1166, 255, 3619